audit   		audit
auditTime   		auditTime

buffer   		buffer
bufferCount   		bufferCount
bufferTime   		bufferTime
bufferToggle   		bufferToggle
bufferWhen   		bufferWhen

catchError   		catchError
combineAll   		combineAll
combineLatest, 		
combineLatestWith   
concatAll   		concatAll
concatMap   		concatMap
concatMapTo   		concatMapTo
concat, 		concatWith   concatWith
connect   		connect
count   		count

debounce   		debounce
debounceTime   		debounceTime
defaultIfEmpty   	defaultIfEmpty
delay 
delayWhen   		delayWhen
dematerialize   	dematerialize
distinct   		distinct
distinctUntilChanged   	distinctUntilChanged
distinctUntilKeyChanged distinctUntilKeyChanged

elementAt   		elementAt
endWith   		endWith
every   		every
exhaust   		exhaust
exhaustMap   		exhaustMap
expand   		expand

filter   		filter
finalize   		finalize
find   			find
findIndex   		findIndex
first   		first

groupBy   		groupBy

ignoreElements   	ignoreElements
isEmpty   		isEmpty
last   			last

map   			map
mapTo   		mapTo
materialize   		materialize
max   			max
mergeWith
merge
mergeAll   		mergeAll
mergeMap, 
flatMap   
mergeMapTo   		mergeMapTo
mergeScan   		mergeScan
min   			min
multicast   		multicast

observeOn   		observeOn
onErrorResumeNext   

pairwise   		pairwise
partition   		partition
pluck   		pluck
publish   		publish
publishBehavior   	publishBehavior
publishLast   		publishLast
publishReplay   	publishReplay

race, 
raceWith
reduce   		reduce
repeat   		repeat
repeatWhen   		repeatWhen
retry   		retry
retryWhen   		retryWhen
refCount   		refCount

sample   		sample
sampleTime   		sampleTime
scan   			scan
sequenceEqual   	sequenceEqual
share   		share
shareReplay   		shareReplay
single   		single
skip   			skip
skipLast   		skipLast
skipUntil   		skipUntil
skipWhile   		skipWhile
startWith   		startWith
subscribeOn   		subscribeOn
switchAll   		switchAll
switchMap   		switchMap
switchMapTo   		switchMapTo
switchScan   		switchScan

take   			take
takeLast   		takeLast
takeUntil   		takeUntil
takeWhile   		takeWhile
tap   			tap
throttle   		throttle
throttleTime   		throttleTime
throwIfEmpty   		throwIfEmpty
timeInterval   		timeInterval
timeout   		timeout
timeoutWith   		timeoutWith
timestamp   		timestamp
toArray   		toArray

window   		window
windowCount   		windowCount
windowTime   		windowTime
windowToggle   		windowToggle
windowWhen   		windowWhen
withLatest   		withLatest

zip, 
zipWith
zipAll   		zipAll