actions
----------------------------------------------------------------------------------------------------
ngrx-actions-setup		Fully configured Action constants, creators with success and fail.
ngrx-create-action-setup	createAction setup
ngrx-create-action		createAction
ngrx-create-action-props	createAction with props
ngrx-actions-setup-crud		Fully configured Actions for CRUD operations.
ngrx-action			Action
ngrx-action-success		Success Action
ngrx-action-fail		Fail Action

effects
-----------------------------------------------------------------------------------------------------
ngrx-effect-setup		Fully configured Effect
ngrx-effect			Effect
ngrx-create-effect-setup	Fully configured Effect using createEffect
ngrx-create-effect		createEffect function
ngrx-root-effect-registration	Effect Registration for root module
ngrx-feat-effect-registration	Effect Registration for feature module

reducers
------------------------------------------------------------------------------------------------------
ngrx-reducer			Reducer
ngrx-reducer-setup		Reducer with state definition
ngrx-on	on

selectors
-----------------------------------------------------------------------------------------------------
ngrx-selector			createSelector()
ngrx-feat-selector		createFeatureSelector()
ngrx-store-select		store.select()

dispatch
---------------------------------------------------------------------------------------------------
ngrx-dispatch-action		store.dispatch()

devtools
-----------------------------------------------------------------------------------------------------
ngrx-devtool-instrument		Store devtool instrument specification

entities
-------------------------------------------------------------------------------------------------------
ngrx-entities-setup		Data entities setup
ngrx-entity-adapter-setup	Entity adapter
ngrx-entity-store-registration	Entity store registration
ngrx-entity-data-service	Entity service data service
